{
  "maze": [
    ["#","#","#","#","#","E","#"],
    ["#","T","T","B"," "," ","#"],
    ["#"," ","#"," ","#","#","#"],
    ["#"," ","#"," "," ","G","#"],
    ["#","G","#"," ","#","#","#"],
    ["#","T","#","L"," ","G","#"],
    ["#","#","#","#","S","#","#"]
  ]
}